16
16
01 02 02 02 02 02 02 02 02 02 02 02 02 02 02 03
11 42 42 42 43 42 42 42 42 42 42 42 43 42 42 13
11 40 40 40 40 40 40 40 40 36 40 40 40 40 40 13
11 40 40 40 40 40 40 40 40 40 40 40 40 40 40 13
11 40 40 40 40 40 40 40 40 40 40 40 40 40 40 13
11 40 36 40 40 40 40 40 40 40 40 40 41 40 40 13
11 40 40 40 40 40 40 40 41 40 40 40 40 40 40 13
11 40 40 40 41 40 40 40 40 40 40 40 40 40 40 13
11 40 40 40 40 40 40 40 40 40 40 36 40 40 40 13
11 40 40 40 40 40 40 40 40 40 40 40 40 40 40 13
11 41 40 40 40 40 41 40 40 40 40 40 40 36 40 13
11 41 41 40 40 40 36 40 40 40 40 40 40 40 40 13
11 40 40 40 40 40 40 40 40 40 40 40 40 40 40 13
11 40 40 40 40 41 40 40 40 40 40 40 40 40 40 13
11 40 40 40 40 40 40 40 40 40 40 40 40 40 40 13
21 22 22 22 22 22 22 22 22 22 22 22 22 22 22 23